................
##########&&###.
#<...+........#.
######........#.
~~~~~#........+.
.^^^.#........#.
.^B^.##########.
.^^^............
....########....
...#........#...
...#..+..+..#...
...#........#...
...#.+....+.#...
....#.++++.#....
.....######.....
.......zz....z..
.##........Z....
.#.########.....
.###....+..+!!|.
.#.########.....
.##..........>..
................
