................
##########&&###.
#<...+........#.
######........#.
~~~~~#........+.
.^^^.#........#.
.^F^.##########.
.^^^............
....########....
...#........#...
...#..+..+..#...
...#........#...
...#.+....+.#...
....#.++++.#....
.....######.....
................
.##.............
.#.########.....
.###....+..+!!|.
.#.########.....
.##..........>..
................
.#............#.
................